Identificador;Nombre;Goles a Favor;Goles en Contra;Diferencia de Goles;Puntos
1;Sportivo del Bono;25;15;10;15
2;Sportivo Desamparados;20;18;2;12
3;San Martin de San Juan;22;20;2;12
4;Alianza Villa Krause;18;22;-4;6
5;Union Villa Krause;15;25;-10;3
6;Colon Juniors;30;10;20;18
7;Atletico Trinidad;28;12;16;15
8;Sportivo Pe√±arol;16;28;-12;3
9;Atletico San Martin;24;16;8;12
10;Villa Obrera;14;24;-10;3
