Identificador;Nombre;Goles a Favor;Goles en Contra;Diferencia de Goles;Puntos
3;San Martin de San Juan;10;7;3;9
1;Sportivo del Bono;7;3;4;7
6;Colon Juniors;7;4;3;7
2;Sportivo Desamparados;6;4;2;7
9;Atletico San Martin;6;5;1;6
4;Alianza Villa Krause;5;5;0;6
5;Union Villa Krause;5;5;0;6
8;Sportivo PeÃ±arol;4;7;-3;4
7;Atletico Trinidad;4;8;-4;1
10;Villa Obrera;3;9;-6;1
